##########
#@   #  P#
#   ##   #
# *      #
#   ##   #
#      E #
##########
