####################
#@   P        K   #
#   ###  #####    #
#   H        S    #
#   ###  ###  F   #
#            O    #
#   ###  ###  L  D#
#              E  #
####################
