####################
#@  #  M  P   K   #
#   #  ### ###   #
#   #   S   O    #
#   ##### ###    #
#      H         #
#   ### ### D    #
#   L        E   #
####################
