####################
#@  H W   K  W H  #
#                  #
#      S B S       #
#                  #
#  O          O    #
#        P   L D   #
#             E    #
####################
