####################
#@ M  P S M   K   #
# ### ####### ### #
#                 #
# H#O# #H#F#      #
#        L        #
# ### ####### D   #
#             E   #
####################
